111111111
101111C01
10P001101
10C000E01
100011101
111111111