11111111111111111111
10011111000011000C01
1010P0010110110V1111
1000011C0000000110E1
1V11C000011111011001
1000001100100C001011
111110000111111000V1
111C0011111111111111
100000V0001111100011
11101101101111C01011
10000001000011111001
1111110C011111100011
11111111000000001111
11111111111111111111
